1111111111111111111111111111111111
1000000000000000000000000010001001
1011111111110000000000111111001001
1111100000000000000000000000001001
1000000000111111111000000000001001
1000000000000010000000001111001001
1111111100000010011100001100000001
1000000000000010000100001100000001
1111111111111111111111111111111111