1111111111111111111111111111111111
1E0000000000000000C00110000C000001
1111111100001111000001100001111111
10C0000000000000000000000000000001
1000000001111110000111100111100001
100110000000000000000110011C000001
1001100000011111111111100111111001
10P0000110000000011000000000000001
1111111111111111111111111111111111
