111111111111
111E00000011
1111P0000C11
111111111111
