111111111111
1110000E0011
1111P0000C11
111111111111
